111111111
100000C01
10P001111
10C001E11
100001111
111111111