111111111
100000C01
10P001111
10C000E11
100001111
111111111