111111111
100C00001
1P000C0E1

100C00001
111111111