11111111111111111111
1P000
10
10
10
1
1
1
1
1
1
1
1
1
1
1
1
1
1E1
11111111111111111111
